111111111111111
100001242100001
100001000100001
111111000111111
102000202000201
150020000020051
102000202000201
111111000111111
100001000100001
100001242100001
111111111111111
