111111111111111
150002040200051
101210101010101
100000000000021
121012101012101
100000000000001
101210101210121
120000000000001
101010101012101
150002040200051
111111111111111
