111111111111111
100101400000051
101001011111001
100100000000001
101001110101001
100000000100001
101010110101001
100100000000001
110000000000001
150100000000001
111111111111111
