111111111111111
100000000000001
101000000000001
101400000000001
101222000000001
100000000000001
100000000000001
150005000000001
100000000000001
100000000000001
111111111111111
