111111111111111
120101111001021
102002141020201
110000200000011
100010111010001
151000222000151
100010111010001
110000002000011
102020141200201
120100111101021
111111111111111
