111111111111111
150000000000051
122222220222221
121212212002001
121212242002001
122222220002001
100200242002001
100200212002001
100200222002001
150000000000051
111111111111111
