111111111111111
100200000002001
110111111111101
100200000002001
101101111101011
150101004101051
110101011101101
100101000001001
101101111111011
100200000002001
111111111111111
