111111111111111
100200040002001
101010111010101
100201020102001
101010010010101
150020242020051
101010010010101
100201020102001
101010111010101
100200040002001
111111111111111
